24 24
1 1 1 1 1 1 1 1 1 1 1 1 1 1 1 1 1 1 1 1 1 1 1 1
1 0 0 0 0 0 0 0 0 0 0 0 0 0 0 1 0 0 0 0 0 0 1 1 
1 0 1 1 1 1 1 0 1 0 1 0 1 1 1 1 0 1 0 1 1 0 0 1
1 0 1 0 0 0 1 0 1 0 1 1 0 7 6 1 0 0 1 0 0 1 0 1
1 0 1 0 1 0 1 0 1 0 0 1 0 1 1 1 0 1 0 0 0 1 0 1
1 0 1 0 1 0 1 0 1 0 0 1 0 0 0 1 0 1 0 0 1 1 0 1
1 0 1 0 1 0 1 0 0 0 1 1 1 1 0 1 0 0 0 1 0 1 0 1
1 0 1 5 1 0 0 1 1 0 1 0 7 1 5 1 1 1 1 1 5 0 0 1
1 0 1 0 1 0 0 0 1 0 1 0 1 1 0 0 0 0 0 1 1 1 0 1
1 0 1 0 1 0 1 0 1 0 0 0 0 1 1 1 1 1 0 1 0 1 0 1
1 0 1 0 1 0 1 0 1 0 1 0 1 5 0 0 0 1 0 0 0 1 0 1
1 0 1 0 1 0 1 0 1 0 0 0 1 1 0 1 0 1 1 0 1 1 0 1
1 0 1 0 1 0 1 0 1 1 1 0 0 0 0 0 0 0 0 0 0 1 0 1
1 0 1 0 1 0 1 7 6 1 1 1 1 1 1 1 1 1 0 1 0 1 0 1 
1 0 1 0 1 0 1 1 1 1 5 0 0 0 0 1 0 0 0 0 0 1 0 1
1 0 1 0 1 0 0 0 0 1 1 1 1 1 0 4 0 1 1 4 1 1 0 1
1 0 1 0 1 0 1 1 1 1 1 0 0 0 0 1 0 0 1 0 0 1 0 1
1 0 1 0 1 0 1 0 0 0 1 0 1 1 1 1 1 4 1 1 0 1 0 1
1 0 1 0 1 0 1 0 1 0 1 0 1 0 0 0 0 0 0 1 0 1 0 1
1 0 1 0 1 0 1 0 1 0 1 0 1 0 1 1 1 1 1 1 0 1 0 1
1 3 1 0 1 0 0 0 1 0 0 0 1 6 1 6 0 0 0 0 0 1 5 1
1 0 1 0 1 1 1 1 1 1 1 1 1 1 1 1 1 1 1 1 1 1 0 1
1 2 1 6 0 0 0 0 0 4 0 0 0 0 4 0 0 0 0 4 0 6 0 1
1 1 1 1 1 1 1 1 1 1 1 1 1 1 1 1 1 1 1 1 1 1 1 1
