32 32
1 1 1 1 1 1 1 1 1 1 1 1 1 1 1 1 1 1 1 1 1 1 1 1 1 1 1 1 1 1 1 1
1 2 0 0 0 0 8 0 0 0 0 0 0 0 0 0 0 0 0 0 0 0 0 0 0 0 0 0 0 0 0 1
1 0 1 1 1 1 1 1 1 1 0 1 1 1 1 0 1 1 1 1 1 1 0 1 1 1 1 1 0 0 0 1
1 0 1 8 0 0 0 0 0 0 0 0 0 0 0 0 0 1 0 0 0 0 0 0 0 0 0 0 0 1 0 1
1 0 1 0 1 1 1 1 5 1 1 1 1 5 1 1 1 1 1 1 1 1 1 5 1 1 1 1 6 1 0 1 
1 0 1 0 1 0 0 0 0 0 0 0 0 0 0 0 6 1 7 6 0 0 0 0 0 0 8 1 1 1 0 1
1 8 1 0 1 0 1 1 1 1 1 1 1 1 1 1 1 1 1 1 1 1 1 1 1 1 0 1 6 1 0 1
1 0 1 0 1 0 0 0 0 7 1 0 0 0 0 0 0 0 0 0 0 0 0 0 0 1 0 1 0 1 0 1
1 0 1 0 1 1 1 1 1 1 1 0 1 1 1 1 1 1 0 1 1 1 1 1 0 1 0 1 0 1 0 1
1 0 0 4 0 6 1 0 0 0 0 0 0 0 0 0 0 1 8 0 0 0 0 1 0 1 0 1 0 1 0 1
1 0 1 0 1 1 1 0 1 1 1 5 1 1 1 0 0 1 1 1 1 1 0 1 0 1 0 1 0 1 0 1
1 0 1 0 1 0 0 0 1 6 1 1 1 7 1 4 0 0 0 0 0 1 0 1 0 1 0 1 0 1 0 1
1 0 1 7 1 1 1 0 1 0 0 5 0 0 1 1 1 1 1 0 0 1 0 1 0 1 0 1 0 1 0 1
1 0 1 1 1 0 1 0 1 0 0 1 0 0 1 0 5 0 1 0 5 1 0 1 0 1 0 1 0 1 0 1
1 0 5 6 1 0 1 0 1 1 0 1 0 1 1 0 1 0 1 1 1 1 0 1 0 1 0 5 0 1 0 1
1 0 1 1 1 0 1 0 0 0 0 1 0 1 0 0 1 0 1 6 5 1 0 1 0 1 0 1 0 6 0 1
1 0 1 6 1 0 1 1 1 1 1 1 0 1 0 1 1 0 1 1 0 1 0 1 0 1 0 1 0 1 0 1
1 0 1 7 1 0 1 0 0 0 0 0 0 1 0 1 0 5 6 1 0 1 0 1 0 1 0 1 0 1 0 1
1 0 1 0 1 0 1 0 0 1 1 1 1 1 0 1 4 4 4 1 0 1 0 1 0 1 1 1 0 1 0 1
1 0 1 0 1 0 1 1 0 0 0 0 0 0 0 1 4 3 4 1 0 0 0 1 0 1 6 1 0 1 0 1
1 0 8 0 1 0 0 1 7 0 1 1 1 1 1 1 1 1 1 1 1 1 0 1 0 1 7 1 0 1 0 1
1 0 1 0 1 0 1 1 1 1 1 0 0 4 0 0 0 0 0 0 6 1 0 1 0 1 0 1 0 1 0 1
1 0 1 0 1 0 1 1 0 0 0 0 1 1 1 1 1 0 1 1 1 1 7 1 0 1 0 1 0 1 0 1
1 0 1 0 1 0 1 5 0 1 1 1 1 0 0 0 1 0 1 0 5 1 1 1 0 1 0 1 7 1 0 1
1 0 1 0 1 0 1 1 7 0 0 0 0 0 1 0 1 0 0 0 0 0 0 0 0 1 0 1 1 1 0 1
1 0 1 0 1 0 1 1 1 1 1 1 1 1 1 0 1 1 1 1 1 1 1 1 1 1 0 1 0 1 0 1
1 0 1 0 1 0 0 0 0 0 0 0 0 0 0 0 0 0 1 6 5 0 0 0 0 0 0 0 0 1 0 1
1 0 1 0 1 1 1 1 1 0 1 1 1 1 1 1 1 1 1 1 1 1 1 1 1 1 1 1 0 1 0 1
1 0 0 4 0 0 7 6 1 0 0 0 0 0 0 0 0 5 0 0 0 0 0 7 6 1 0 0 0 1 0 1
1 0 1 1 1 1 1 1 1 1 1 1 1 1 0 1 1 1 1 0 1 1 1 1 1 1 1 1 0 0 0 1
1 8 0 0 0 0 0 0 8 0 0 0 0 0 0 0 0 0 0 0 0 0 0 0 0 8 0 0 0 4 4 1
1 1 1 1 1 1 1 1 1 1 1 1 1 1 1 1 1 1 1 1 1 1 1 1 1 1 1 1 1 1 1 1
